Banquet: Bữa tiệc
Invitation: Lời mời
attendee: Người tham dự
retirement: Sự nghỉ hưu, giải nghệ
venue: Địa điểm tổ chức
register, enroll in, sign up: Đăng ký, ghi danh
corporate event: Sự kiện công ty
company retreat: Buổi dã ngoại công ty
Tradeshow: Triển lãm thương mại
foundation ceremony: Lễ kỷ niệm thành lập
attend a training session: Tham gia chương trình đào tạo
adjust the work schedule: Điều chỉnh lịch làm việc
make/give a presentation: Thuyết trình
call off, cancel : Hủy bỏ
position: Vị trí
résumé : Sơ yếu lý lịch
qualification: Bằng cấp
candidate, applicant: Ứng viên
complete, finish: Hoàn thành
submit: nộp, trình
hire, recruit, employ: Thuê, tuyển dụng
portfolio: Danh mục đầu tư
employment agency: Công ty môi giới việc làm
recommendation letter: Thư giới thiệu
job opening: Cơ hội việc làm
place an advertisement: Đặt quảng cáo
be qualified for: Có đủ tư cách, có đủ trình độ chuyên môn cho...
to conduct an interview: Tiến hành phỏng vấn
work on: Làm việc về cái gì
specialize in: chuyên về
co-worker, colleague: đồng nghiệp
employee, staff, worker: Nhân viên
predecessor: Tiền bối
replacement: Sự thay thế
performance: Buổi biểu diễn, hiệu suất
raise: sự nâng, sự tăng
benefit: Lợi ích
cover: Bao bọc, bao gồm, bảo vệ...
transfer: Di chuyển
Human resources, personnel department: Bộ phận nhân sự
time sheet: Bảng chấm công
take over the position: Tiếp quản vị trí
to be in charge of, to be responsible for: Chịu trách nhiệm
contribute to: Đóng góp vào
be promoted to: đc thăng chức lên
lay off, dismiss, fire: Sa thải
be dedicated to: cống hiến cho, tận tụy với.